7 8 9 10 11 7 8 9 10 11 7 8 9 10 11 7 8 9 10 11 7 8 9 10 11 7 8 9 10 11 7 8 9 10 11 7 8 9 10 11 7 8 9 10 11 7 8 9 10 11 
12 13 14 15 16 12 13 14 15 15 12 13 14 15 16 12 13 14 15 16 12 13 14 15 16 12 13 14 15 16 12 13 14 15 16 12 13 14 15 16 12 13 14 15 16 12 13 14 15 16 
17 18 19 20 21 17 18 18 20 21 17 18 19 18 21 17 18 19 20 21 17 18 19 20 21 17 18 19 20 21 17 18 19 20 21 17 18 19 20 21 17 18 19 20 6 17 18 19 20 21 
7 8 9 10 11 7 8 9 10 11 7 8 9 10 11 7 8 9 10 11 7 8 9 10 11 1 2 7 8 9 10 11 7 8 9 10 11 7 8 9 10 11 0 1 2 7 8 9 10 11 
12 13 14 15 16 12 13 14 15 16 12 13 14 15 16 12 13 14 15 16 12 13 14 16 16 3 4 12 13 14 15 16 12 13 14 15 16 12 13 14 15 16 0 3 4 12 13 14 15 16 
17 18 19 20 21 17 18 19 20 21 17 18 19 20 21 17 18 19 20 21 17 18 19 20 21 5 6 17 18 19 20 21 17 18 19 20 21 17 18 19 20 21 0 5 6 17 18 19 20 21 
7 8 9 10 11 7 8 9 10 11 7 8 9 10 11 0 0 0 0 0 0 0 0 0 0 0 0 7 8 9 10 11 1 2 0 0 0 0 0 0 7 8 9 10 11 7 8 9 10 11 
12 13 14 15 16 12 13 14 15 16 12 13 14 15 16 0 0 0 0 0 23 24 25 0 0 0 0 12 13 14 15 16 3 4 41 51 52 52 53 0 12 13 14 15 16 12 13 14 15 16 
17 18 19 20 21 17 18 19 20 21 17 18 19 20 21 0 0 0 0 0 26 27 28 0 0 0 0 17 18 19 20 21 5 6 41 54 59 59 55 0 17 18 19 20 21 17 18 19 20 21 
7 8 9 10 11 7 8 9 10 11 7 8 9 10 11 0 0 0 0 0 29 30 31 70 0 0 0 1 2 42 44 1 2 0 41 54 59 59 55 0 7 8 9 10 11 7 8 9 10 11 
12 13 14 15 16 12 14 14 15 16 12 13 14 15 16 0 0 0 0 0 35 36 37 0 0 0 0 3 4 45 47 3 4 0 41 56 57 57 58 0 12 13 14 15 16 12 13 14 15 16 
17 18 19 20 21 17 18 19 20 21 17 18 19 20 21 0 0 0 0 0 0 0 0 0 0 0 0 5 6 45 47 5 6 0 0 0 0 0 0 0 17 18 19 20 21 17 18 19 20 21 
7 8 9 10 11 7 8 9 10 11 7 8 9 10 11 7 8 9 10 11 0 0 0 0 0 0 0 1 2 45 47 1 2 0 0 0 0 0 1 2 7 8 9 10 11 7 8 9 10 11 
12 13 14 15 16 12 13 14 15 16 12 13 14 15 16 12 13 14 15 16 0 0 0 0 0 0 0 3 4 45 47 3 4 0 0 0 0 0 3 4 12 13 14 15 16 12 13 14 15 16 
17 18 19 20 21 17 18 19 20 21 17 18 19 20 21 17 18 19 20 21 0 0 0 0 0 0 0 5 6 45 47 5 6 0 0 0 0 0 5 6 17 18 19 20 21 17 18 19 20 21 
1 2 1 2 1 2 0 0 0 0 0 0 0 1 2 7 8 9 10 11 0 0 0 0 0 0 0 1 2 45 47 1 2 0 0 0 0 0 0 0 7 8 9 10 11 7 8 9 10 11 
3 4 3 4 3 4 0 60 61 61 62 0 0 3 4 12 13 14 15 16 0 0 0 0 0 0 0 3 4 45 47 3 4 0 0 0 0 0 0 0 12 13 14 15 16 12 13 14 15 16 
5 6 5 6 5 6 0 63 68 68 64 0 0 5 6 17 18 19 20 21 0 0 0 0 0 0 0 5 6 45 47 5 6 0 0 0 0 0 0 0 17 18 19 20 21 17 18 19 20 21 
1 2 1 2 1 2 0 65 66 66 67 0 0 0 0 7 8 9 10 11 0 0 69 0 0 0 0 1 2 45 47 1 2 0 0 0 0 0 0 0 7 8 9 10 11 7 8 9 10 11 
3 4 3 4 3 4 0 0 0 0 0 0 0 0 0 12 13 14 15 16 0 0 0 0 0 0 0 3 4 45 47 3 4 0 0 0 0 0 0 0 12 13 14 15 16 12 13 14 15 16 
5 6 5 6 5 6 7 8 9 10 11 0 0 0 69 17 18 19 20 21 0 0 0 0 0 0 0 5 6 45 47 5 6 0 0 0 0 0 0 0 17 18 19 20 21 17 18 19 20 21 
7 8 9 10 11 0 12 13 14 15 16 0 0 0 0 7 8 9 10 11 1 2 0 0 0 0 0 1 2 45 47 1 2 1 2 0 0 0 0 0 7 8 9 10 11 7 8 9 10 11 
12 13 14 15 16 0 17 18 19 20 21 0 0 0 0 12 13 14 15 16 3 4 0 0 0 0 0 3 4 45 47 3 4 3 4 0 0 39 0 0 12 13 14 15 16 12 13 14 15 16 
17 18 19 20 21 7 8 9 10 11 0 0 0 0 0 17 18 19 20 21 5 6 0 0 0 0 0 5 6 48 50 5 6 5 6 0 0 0 0 0 17 18 19 20 21 17 18 19 20 21 
7 8 9 10 11 12 13 14 15 16 0 0 0 0 0 0 0 0 0 0 0 0 0 0 0 0 0 0 0 0 0 0 0 0 0 0 0 0 0 0 0 0 0 1 2 7 8 9 10 11 
12 13 14 15 16 17 18 19 20 21 42 43 43 43 43 43 43 43 43 43 43 43 43 43 43 43 43 43 43 43 43 44 0 1 2 42 43 43 43 43 44 22 0 3 4 12 13 14 15 16 
17 18 19 20 21 1 2 0 0 0 45 46 46 46 46 46 46 46 46 46 46 46 46 46 46 46 46 46 46 46 46 47 0 3 4 45 46 46 46 46 47 22 0 5 6 17 18 19 20 21 
7 8 9 10 11 3 4 0 1 2 48 49 49 49 49 49 49 49 49 49 49 49 49 49 49 49 49 49 49 49 49 50 0 5 6 45 46 46 46 46 47 22 1 2 7 8 9 10 11 105 
12 13 14 15 16 5 6 0 3 4 0 0 0 0 0 0 0 0 0 0 0 0 0 0 0 0 0 0 0 0 1 2 40 0 40 45 46 46 46 46 47 22 3 4 12 13 14 15 16 101 
17 18 19 20 21 1 2 0 5 6 0 0 0 0 0 0 0 366 367 367 367 366 0 0 0 0 0 0 0 0 3 4 0 40 0 48 49 49 49 49 50 22 5 6 17 18 19 20 21 101 
7 8 9 10 11 3 4 0 0 1 2 1 2 0 0 0 0 369 354 355 356 370 0 0 0 0 0 0 0 0 5 6 1 2 7 8 9 10 11 7 8 9 10 11 7 8 9 10 11 101 
12 13 14 15 16 5 6 0 0 3 4 3 4 0 0 0 0 369 357 358 359 370 0 0 0 0 0 0 0 0 0 0 3 4 12 13 14 15 16 12 13 14 15 16 12 13 14 15 16 101 
17 18 19 20 21 0 0 0 0 5 6 5 6 0 0 0 0 369 360 361 362 370 0 38 0 0 0 0 0 0 0 0 5 6 17 18 19 19 21 17 18 19 20 21 17 18 19 20 21 101 
102 7 8 9 10 11 7 8 9 10 11 0 0 0 0 0 0 369 363 364 365 370 0 0 0 0 0 0 0 0 0 1 2 105 99 99 99 99 99 99 99 99 99 99 99 99 99 99 99 100 
97 12 13 14 15 16 12 13 14 15 16 7 8 9 10 11 0 371 367 0 367 373 0 0 0 0 0 0 0 0 0 3 4 101 59 59 59 59 59 59 59 59 59 59 59 59 59 59 59 59 
97 17 18 19 20 21 17 18 19 20 21 12 13 14 15 16 0 0 70 0 0 0 0 0 0 0 0 0 0 0 0 5 6 101 59 59 59 59 59 59 59 59 59 59 59 59 59 59 59 59 
97 7 8 9 10 11 0 0 0 0 0 17 18 19 20 21 0 0 0 0 0 0 0 0 0 38 0 0 0 0 0 0 0 101 59 59 59 59 59 59 59 94 95 95 95 95 96 59 59 59 
97 12 13 14 15 16 7 8 9 10 11 7 8 9 10 11 0 0 7 8 9 10 11 0 1 2 0 1 2 0 0 1 2 101 59 59 59 59 59 59 59 97 0 0 0 0 101 59 59 59 
97 17 18 19 20 21 12 13 14 15 16 12 13 14 15 16 0 0 12 13 14 15 16 0 3 4 0 3 4 0 0 3 4 101 59 59 59 59 59 59 59 97 0 0 0 0 101 59 59 59 
97 0 0 0 0 0 17 18 19 20 21 17 18 19 20 21 84 85 17 18 19 20 21 0 5 6 0 5 6 0 0 5 6 54 59 59 59 59 59 59 59 97 0 0 0 0 101 59 59 59 
98 99 99 99 99 99 99 99 99 99 99 99 99 99 99 99 86 87 99 99 99 99 102 1 2 0 105 99 99 102 1 2 0 54 59 59 59 59 59 59 59 98 99 99 99 99 100 59 59 59 
59 59 59 59 59 59 59 59 59 59 59 59 59 59 59 59 88 89 59 59 59 59 97 3 4 0 101 59 59 97 3 4 0 101 59 59 59 59 59 59 59 59 59 59 59 59 59 59 59 59 
59 59 59 59 59 59 59 59 59 59 59 59 59 59 59 59 88 89 59 59 59 59 97 5 6 0 101 59 59 97 5 6 0 101 59 59 59 59 59 59 59 59 59 59 59 59 59 59 59 59 
59 59 59 59 59 59 59 59 59 59 59 59 59 59 59 59 88 89 59 59 59 59 98 99 99 99 100 59 59 98 99 99 99 100 59 59 59 59 59 59 59 59 59 59 59 59 59 59 59 59 
59 59 59 59 59 59 59 59 59 59 59 59 59 94 95 95 88 89 95 95 96 59 59 59 59 59 59 59 59 59 59 59 59 59 59 59 59 59 59 59 59 59 59 59 59 59 59 59 59 59 
59 59 59 59 59 59 59 59 59 59 59 59 59 97 0 0 103 104 0 0 101 59 59 59 59 59 59 59 59 59 59 59 59 59 59 59 59 59 59 59 59 59 59 59 59 59 59 59 59 59 
59 59 59 59 59 59 59 59 59 59 59 59 59 97 0 0 0 0 0 0 101 59 59 59 59 59 59 59 59 59 59 59 59 59 59 59 59 59 59 59 59 59 59 59 59 59 59 59 59 59 
59 59 59 59 59 59 59 59 59 59 59 59 59 97 0 0 0 0 0 0 101 59 59 59 59 59 59 59 59 59 59 59 59 59 59 59 59 59 59 59 59 59 59 59 59 59 59 59 59 59 
59 59 59 59 59 59 59 59 59 59 59 59 59 97 0 0 0 0 0 0 101 59 59 59 59 59 59 59 59 59 59 59 59 59 59 59 59 59 59 59 59 59 59 59 59 59 59 59 59 59 
59 59 59 59 59 59 59 59 59 59 59 59 59 97 0 0 0 0 0 0 101 59 59 59 59 59 59 59 59 59 59 59 59 59 59 59 59 59 59 59 59 59 59 59 59 59 59 59 59 59 
