0 1 2 0 0 0 0 0 0 1 2 0 0 0 1 2 0 0 0 0 0 0 0 0 0 0 0 0 0 0 0 0 0 0 0 1 2 0 1 2 0 0 0 0 0 1 2 1 2 0
0 3 4 0 7 8 9 10 11 3 4 0 0 0 3 4 0 0 0 7 8 9 10 11 0 0 0 0 7 8 9 10 11 0 0 3 4 0 3 4 7 8 9 10 11 3 4 3 4 0
0 5 6 0 12 13 14 15 16 5 6 0 0 0 5 6 0 0 0 12 13 14 15 16 0 1 2 0 12 13 14 15 16 1 2 5 6 0 5 6 12 13 14 15 16 5 6 5 6 0
0 0 0 0 17 18 19 20 21 0 0 0 0 0 0 0 0 0 0 17 18 19 20 21 0 3 4 0 17 18 19 20 21 3 4 0 0 0 0 0 17 18 19 20 21 1 2 0 0 0
0 1 2 1 2 0 0 1 2 0 0 0 1 2 1 2 0 0 1 2 0 0 0 0 0 5 6 0 0 0 0 0 0 5 6 0 0 0 0 0 0 1 2 0 0 3 4 1 2 0
0 3 4 3 4 0 0 3 4 1 2 0 3 4 3 4 0 0 3 4 0 0 0 0 0 0 0 0 0 0 0 0 0 0 0 0 0 0 39 0 0 3 4 0 0 5 6 3 4 0
0 5 6 5 6 0 0 5 6 3 4 0 5 6 5 6 0 0 5 6 0 0 0 1 2 22 23 24 0 0 0 1 2 0 0 0 0 0 0 0 0 5 6 0 0 0 0 5 6 0
0 1 2 0 0 0 0 0 0 5 6 0 1 2 0 0 1 2 0 0 0 1 2 3 4 25 26 27 0 1 2 3 4 0 0 1 2 0 0 0 1 2 0 1 2 1 2 0 0 0
0 3 4 0 0 0 1 2 0 0 0 0 3 4 0 0 3 4 0 0 0 3 4 5 6 28 29 30 69 3 4 5 6 0 0 3 4 0 0 0 3 4 0 3 4 3 4 1 2 0
0 5 6 0 0 0 3 4 0 0 0 0 5 6 0 0 5 6 0 0 0 5 6 0 0 34 35 36 0 5 6 0 0 0 0 5 6 0 0 0 5 6 0 5 6 5 6 3 4 0
0 0 1 2 0 0 5 6 0 0 0 0 0 0 0 0 0 0 0 0 0 0 0 0 0 0 0 0 0 0 0 0 40 0 0 1 2 0 0 0 0 0 0 0 0 0 0 5 6 0
0 0 3 4 0 7 8 9 10 11 7 8 9 10 11 0 0 0 0 39 0 0 0 0 0 0 0 0 0 0 0 0 0 0 0 3 4 0 0 0 0 0 0 0 0 0 0 1 2 0
1 2 5 6 0 12 13 14 15 16 12 13 14 15 16 0 0 0 0 0 37 0 0 0 1 2 0 0 0 0 0 0 0 0 0 5 6 0 0 1 2 0 0 0 0 0 0 3 4 0
3 4 0 0 0 17 18 19 20 21 17 18 19 20 21 0 0 0 0 0 0 0 0 0 3 4 0 0 0 0 0 0 0 1 2 0 0 0 0 3 4 0 0 0 0 0 0 5 6 0
5 6 1 2 0 0 0 0 0 0 0 0 0 0 0 0 0 0 0 0 0 0 0 0 5 6 0 0 0 0 1 2 0 3 4 0 0 0 0 5 6 0 0 3 4 0 0 0 0 0
0 0 3 4 0 0 0 0 0 0 0 0 0 0 0 0 0 0 0 0 0 0 0 0 0 0 0 0 0 0 3 4 0 5 6 0 0 0 0 0 0 0 0 5 6 0 0 0 0 0
0 0 5 6 0 0 7 8 9 10 11 0 0 0 0 0 0 0 0 0 0 39 0 0 0 0 37 0 0 0 5 6 0 0 0 0 0 0 0 39 1 2 0 0 0 1 2 1 2 0
0 0 0 0 0 0 12 13 14 15 16 0 0 0 0 37 0 0 0 0 0 0 0 0 0 0 0 0 0 0 0 0 0 0 0 0 0 0 0 0 3 4 0 0 0 3 4 3 4 0
0 0 1 2 0 0 17 18 19 20 21 0 0 0 0 0 0 0 0 0 0 0 0 0 0 0 0 0 0 0 0 0 0 0 0 0 0 0 0 0 5 6 0 0 0 5 6 5 6 0
0 0 3 4 0 0 0 0 0 0 0 0 0 0 0 0 0 0 0 0 1 2 0 0 0 0 0 0 0 1 2 0 0 0 0 1 2 0 0 0 0 1 2 0 0 0 0 1 2 0
0 0 5 6 0 0 0 0 0 0 0 0 0 0 0 0 0 0 0 0 3 4 0 0 0 0 0 0 0 3 4 0 0 1 2 3 4 0 0 0 0 3 4 0 0 0 0 3 4 0
0 0 0 0 0 0 0 0 0 0 0 0 0 0 0 0 0 0 0 0 5 6 0 0 0 40 0 0 0 5 6 0 0 3 4 5 6 0 0 0 0 5 6 0 0 0 0 5 6 0
0 1 2 0 0 0 0 0 0 0 1 2 0 0 0 0 38 0 0 0 0 0 0 0 0 0 0 0 0 0 1 2 0 5 6 0 0 0 1 2 0 0 0 0 0 0 0 1 2 0
0 3 4 0 0 0 0 1 2 0 3 4 0 0 1 2 0 0 0 39 0 0 0 0 0 0 0 0 0 0 3 4 0 0 0 42 43 44 3 4 0 0 0 1 2 0 0 3 4 0
0 5 6 0 0 0 0 3 4 0 5 6 1 2 3 4 0 0 0 0 0 0 0 0 0 0 0 0 0 0 5 6 0 0 0 45 46 47 5 6 0 0 0 3 4 0 0 5 6 0
0 0 0 1 2 0 0 5 6 0 0 0 3 4 5 6 0 0 0 0 0 0 0 1 2 0 0 0 0 0 0 0 0 0 0 48 49 50 0 0 0 0 0 5 6 0 0 0 0 0
0 0 0 3 4 0 0 0 0 0 0 0 5 6 0 0 0 0 0 0 0 0 0 3 4 0 0 0 0 39 0 0 0 0 0 0 1 2 0 0 0 0 1 2 0 0 1 2 0 0
0 1 2 5 6 0 0 1 2 51 52 53 0 0 0 0 0 0 0 39 0 0 0 5 6 0 0 0 0 0 1 2 1 2 0 0 3 4 0 1 2 0 3 4 1 2 3 4 0 0
0 3 4 0 0 0 0 3 4 54 55 56 0 0 0 0 0 0 0 0 0 0 0 0 0 0 1 2 0 0 3 4 3 4 0 0 5 6 0 3 4 0 5 6 3 4 5 6 1 2
0 5 6 0 0 0 0 5 6 57 58 59 0 0 0 0 40 0 0 0 0 0 0 0 0 0 3 4 0 0 5 6 5 6 0 1 2 1 2 5 6 0 1 2 5 6 0 0 3 4
0 0 0 1 2 1 2 0 0 0 0 0 0 0 0 0 0 0 0 0 0 0 0 39 0 0 5 6 0 0 0 1 2 0 0 3 4 3 4 0 0 0 3 4 0 0 0 0 5 6
0 0 0 3 4 3 4 0 0 0 0 1 2 0 0 0 0 0 0 1 2 60 61 61 61 62 1 2 0 0 0 3 4 1 2 5 6 5 6 0 0 0 5 6 1 2 1 2 1 2
0 0 0 5 6 5 6 0 0 0 0 3 4 0 0 0 0 0 0 3 4 63 64 64 64 65 3 4 0 0 0 5 6 3 4 0 1 2 1 2 1 2 0 0 3 4 3 4 3 4
0 0 0 0 0 1 2 0 0 0 0 5 6 0 0 0 0 0 0 5 6 63 64 64 64 65 5 6 0 0 0 1 2 5 6 0 3 4 3 4 3 4 0 0 5 6 5 6 5 6
0 0 1 2 0 3 4 0 0 1 2 0 0 0 0 0 0 0 0 0 0 63 64 64 64 65 0 0 0 0 0 3 4 0 0 0 5 6 5 6 5 6 0 0 0 0 0 0 1 2
0 0 3 4 0 5 6 0 0 3 4 0 0 0 0 0 1 2 0 0 0 66 67 67 67 68 0 0 0 0 0 5 6 0 0 0 0 0 0 0 0 0 1 2 1 2 0 0 3 4
0 0 5 6 0 0 0 0 0 5 6 0 0 0 1 2 3 4 0 0 0 0 39 0 0 0 0 0 0 0 0 0 0 0 0 1 2 1 2 0 0 0 3 4 3 4 1 2 5 6
0 0 0 0 0 0 0 0 0 0 0 0 0 0 3 4 5 6 0 0 0 0 0 0 0 0 0 0 0 0 0 0 0 0 0 3 4 3 4 0 0 0 5 6 5 6 3 4 0 0
0 0 1 2 0 0 7 8 9 10 11 0 0 0 5 6 0 0 0 1 2 0 0 0 0 0 0 0 0 1 2 0 0 0 0 5 6 5 6 0 0 0 0 0 0 0 5 6 1 2
0 0 3 4 0 0 12 13 14 15 16 0 0 0 0 0 0 0 0 3 4 0 0 0 0 0 0 0 0 3 4 0 0 0 0 0 0 1 2 0 0 0 0 0 0 0 0 0 3 4
0 0 5 6 0 0 17 18 19 20 21 1 2 0 0 0 0 0 0 5 6 0 0 0 0 0 0 0 0 5 6 0 0 0 0 0 0 3 4 0 0 0 0 1 2 0 0 0 5 6
0 1 2 0 1 2 0 0 0 0 0 3 4 0 0 1 2 1 2 0 0 0 0 0 1 2 0 0 0 0 0 0 0 0 0 0 0 5 6 0 0 1 2 3 4 0 1 2 1 2
0 3 4 0 3 4 0 0 0 0 0 5 6 0 0 3 4 3 4 0 0 0 0 0 3 4 0 0 0 39 0 0 0 0 7 8 9 10 11 0 0 3 4 5 6 0 3 4 3 4
0 5 6 0 5 6 1 2 0 1 2 0 0 0 0 5 6 5 6 0 39 0 0 0 5 6 0 0 0 0 0 0 0 0 12 13 14 15 16 0 0 5 6 0 0 0 5 6 5 6
1 2 0 1 2 0 3 4 0 3 4 1 2 0 0 0 1 2 1 2 1 2 0 1 2 1 2 1 2 0 1 2 1 2 17 18 19 20 21 1 2 1 2 1 2 0 1 2 1 2
3 4 0 3 4 0 5 6 0 5 6 3 4 0 39 0 3 4 3 4 3 4 0 3 4 3 4 3 4 0 3 4 3 4 0 0 0 0 0 3 4 3 4 3 4 0 3 4 3 4
5 6 0 5 6 0 0 0 0 0 0 5 6 0 0 0 5 6 5 6 5 6 0 5 6 5 6 5 6 0 5 6 5 6 0 0 0 0 0 5 6 5 6 5 6 0 5 6 5 6
