0 0 0 0 0 0 0 0 0 0 0 0 0 0 0 0 0 0 0 0 0 0 0 0 0 0 0 0 0 0 0 0 0 0 0 0 0 0 0 0 0 0 0 0 0 0 0 0 0 0 
0 0 0 0 0 0 0 0 0 0 0 0 0 0 0 0 0 0 0 0 0 0 0 0 0 0 0 0 0 0 0 0 0 124 126 126 126 126 126 126 126 126 126 126 127 0 0 0 0 0 
0 0 0 0 0 0 0 0 0 0 0 0 0 0 0 0 0 0 0 0 0 0 0 0 0 0 0 0 0 0 0 0 0 128 0 0 0 0 0 0 0 0 0 0 129 0 0 0 0 0 
0 0 0 124 125 125 125 125 125 125 125 125 125 125 125 125 125 125 125 125 127 0 0 0 0 0 0 0 0 0 0 0 0 128 0 124 126 126 126 126 126 126 127 0 129 0 0 0 0 0 
0 0 0 128 0 0 0 0 0 0 0 0 0 0 0 0 0 0 0 0 129 0 0 0 0 0 0 0 0 0 0 0 0 128 0 128 0 0 0 0 0 0 129 0 129 0 0 0 0 0 
0 0 0 128 0 124 125 126 126 126 126 126 126 126 126 126 126 126 127 0 129 0 0 0 0 0 0 0 0 0 0 0 0 128 0 128 0 124 125 125 127 0 129 0 129 0 0 0 0 0 
0 0 0 128 0 128 0 0 0 0 0 0 0 0 0 0 0 0 129 0 129 0 0 0 0 0 0 0 0 0 0 0 0 128 0 128 0 128 0 0 129 0 129 0 129 0 0 0 0 0 
0 0 0 128 0 128 0 124 125 125 125 125 125 125 125 125 127 0 129 0 130 136 136 136 136 134 135 136 136 136 136 136 136 137 0 128 0 128 0 0 129 0 129 0 129 0 0 0 0 0 
0 0 0 128 0 128 0 128 124 125 125 125 125 125 125 127 129 0 129 0 0 0 0 0 0 0 0 0 0 0 0 0 0 0 0 128 0 128 0 0 129 0 129 0 129 0 0 0 0 0 
0 0 0 128 0 128 0 128 128 0 0 0 0 0 0 129 129 0 130 136 136 136 136 136 136 134 135 136 136 136 131 131 131 131 131 137 0 128 0 0 129 0 129 0 129 0 0 0 0 0 
0 0 0 128 0 128 0 128 130 136 136 136 136 136 136 137 129 0 0 0 0 0 0 0 0 0 0 0 0 0 0 0 0 0 0 0 0 130 131 131 137 0 129 0 129 0 0 0 0 0 
0 0 0 128 0 128 0 128 0 0 0 0 0 0 0 0 129 0 0 0 0 0 0 0 0 0 0 0 0 0 0 0 0 0 0 0 0 0 0 0 0 0 129 0 129 0 0 0 0 0 
0 0 0 128 0 128 0 130 131 131 131 134 135 131 131 131 137 0 0 0 0 0 0 0 0 0 0 0 0 0 0 0 0 0 0 0 0 0 0 0 0 0 129 0 129 0 0 0 0 0 
0 0 0 128 0 128 0 0 0 0 0 0 0 0 0 0 0 0 0 0 0 0 0 0 0 0 0 124 125 125 125 125 125 125 125 125 125 125 125 125 127 0 129 0 129 0 0 0 0 0 
0 0 0 128 0 128 0 0 124 125 125 125 125 125 125 125 125 125 125 125 125 127 0 0 0 0 0 128 0 0 0 0 0 0 0 0 0 0 0 0 129 0 129 0 129 0 0 0 0 0 
0 0 0 128 0 128 0 0 128 0 0 0 0 0 0 0 0 0 0 0 0 129 0 0 0 0 0 128 0 124 125 125 125 125 125 125 125 125 127 0 129 0 129 0 129 0 0 0 0 0 
0 0 0 128 0 128 0 0 128 0 124 125 125 125 125 125 125 125 125 127 0 129 0 0 0 0 0 128 0 128 0 0 0 0 0 0 0 0 129 0 129 0 129 0 129 0 0 0 0 0 
0 0 0 128 0 128 0 0 128 0 128 0 0 0 0 0 0 0 0 129 69 129 0 0 0 0 0 128 0 128 0 124 125 125 125 125 127 0 129 0 129 0 129 0 129 0 0 0 0 0 
0 0 0 128 0 128 0 0 128 0 128 0 124 126 126 126 126 127 0 129 0 129 0 0 0 0 0 128 0 128 0 128 0 0 0 0 129 0 129 0 129 0 129 0 129 0 0 0 0 0 
0 0 0 128 0 128 0 0 128 0 128 0 128 22 0 0 140 129 0 129 0 129 0 0 0 0 0 128 0 128 0 128 0 0 0 0 129 0 129 0 129 0 129 0 129 0 0 0 0 0 
0 0 0 128 0 128 0 0 128 0 128 0 128 22 0 0 141 129 0 129 0 129 0 0 0 0 0 128 0 128 0 128 0 0 0 0 129 0 129 0 129 0 129 0 129 0 0 0 0 0 
0 0 0 128 0 128 0 0 128 0 128 0 130 131 131 131 131 137 0 129 0 129 0 0 0 0 0 128 0 128 0 128 0 0 0 0 129 140 129 0 129 0 129 0 129 0 0 0 0 0 
0 0 0 128 0 128 0 0 128 0 128 0 0 0 0 0 0 0 0 129 0 129 0 0 0 0 0 128 0 128 0 130 131 131 131 131 138 141 129 0 129 0 129 0 129 0 0 0 0 0 
0 0 0 128 0 128 0 0 128 0 130 131 131 131 131 131 131 131 131 137 0 129 0 0 0 0 0 128 0 128 0 0 0 0 0 0 0 140 129 0 129 0 129 0 129 0 0 0 0 0 
0 0 0 128 0 128 0 0 128 0 0 0 0 0 0 0 0 0 0 69 0 129 0 0 0 0 0 128 0 128 0 0 0 0 0 0 0 141 129 0 129 0 129 0 129 0 0 0 0 0 
0 0 0 128 0 128 0 0 130 136 136 136 136 136 136 136 136 136 136 136 136 137 0 0 0 0 0 128 0 130 131 131 131 134 135 131 131 131 137 0 129 0 129 0 129 0 0 0 0 0 
0 0 0 128 0 128 0 0 0 0 0 0 0 0 0 0 0 0 0 0 0 0 0 0 0 0 0 128 0 0 0 0 0 0 0 0 0 0 0 0 129 0 129 0 129 0 0 0 0 0 
0 0 0 128 0 128 0 124 125 125 125 125 125 125 125 125 125 125 125 125 125 125 125 125 127 0 0 130 136 136 136 136 136 134 135 136 136 136 136 136 137 0 129 0 129 0 0 0 0 0 
0 0 0 128 0 128 0 128 0 0 0 0 0 0 0 0 0 0 0 0 0 0 0 0 129 0 0 0 0 0 0 0 0 0 0 0 0 0 0 0 0 0 129 0 129 0 0 0 0 0 
0 0 0 128 0 128 0 128 0 124 125 125 125 125 125 125 125 125 125 125 125 125 127 0 129 0 0 0 0 0 0 0 0 0 0 0 0 0 0 0 0 0 129 0 129 0 0 0 0 0 
0 0 0 128 0 128 0 128 0 128 69 22 22 22 22 22 22 22 22 22 22 140 129 0 129 0 0 0 0 0 124 125 125 125 125 125 125 125 125 125 127 0 129 0 129 0 0 0 0 0 
0 0 0 128 0 128 0 128 0 128 22 0 0 0 0 0 0 0 0 0 0 141 129 0 129 0 0 0 0 0 128 0 0 0 0 0 0 0 0 0 129 0 129 0 129 0 0 0 0 0 
0 0 0 128 0 128 0 128 0 128 22 0 0 0 0 0 0 0 0 0 0 0 129 0 129 0 0 0 0 0 128 140 140 0 0 0 0 0 0 0 129 0 129 0 129 0 0 0 0 0 
0 0 0 128 0 128 0 128 0 128 22 0 0 0 0 0 0 0 0 0 0 140 129 0 129 0 0 0 0 0 128 141 141 0 0 0 0 0 0 0 129 0 129 0 129 0 0 0 0 0 
0 0 0 128 0 128 0 128 0 128 69 0 0 0 0 0 0 0 0 0 0 141 129 0 129 0 0 0 0 0 128 140 140 140 139 131 131 138 0 0 129 0 129 0 129 0 0 0 0 0 
0 0 0 128 0 128 0 128 0 130 131 131 131 131 131 134 135 131 131 131 131 131 137 140 129 0 0 0 0 0 128 141 141 141 129 0 0 128 0 0 129 0 129 0 129 0 0 0 0 0 
0 0 0 128 0 128 0 128 0 0 0 0 0 0 0 0 0 0 0 0 0 0 0 141 129 0 0 0 0 0 130 136 136 136 137 0 0 130 131 131 137 0 129 0 129 0 0 0 0 0 
0 0 0 128 0 128 0 130 131 131 131 131 131 131 131 134 135 131 131 131 131 131 131 131 137 0 0 0 0 0 0 0 0 0 0 0 0 0 0 0 0 0 129 0 129 0 0 0 0 0 
0 124 125 132 0 128 0 0 0 0 0 0 0 0 0 0 0 0 0 0 0 0 0 0 0 0 0 0 0 0 0 0 0 0 0 0 0 139 131 131 131 131 137 0 129 0 0 0 0 0 
0 128 0 0 0 130 136 136 136 136 136 136 136 136 136 134 135 136 136 136 136 136 136 136 136 136 138 0 0 0 0 0 0 0 0 0 0 129 0 0 0 0 0 0 129 0 0 0 0 0 
0 128 0 0 0 0 0 0 0 0 0 0 0 0 0 0 0 0 0 0 0 0 0 0 0 0 128 0 0 0 0 0 0 0 0 0 0 129 0 139 131 131 131 131 137 0 0 0 0 0 
0 128 0 0 0 0 0 0 139 131 131 131 131 131 131 134 135 131 131 131 131 131 131 131 138 0 128 0 0 0 0 0 0 0 0 0 0 129 0 129 0 0 0 0 0 0 0 0 0 0 
0 128 0 124 125 125 127 0 129 0 0 0 0 0 0 0 0 0 0 0 0 0 0 0 128 0 130 131 131 131 131 131 131 131 136 136 136 137 0 129 0 0 0 0 0 0 0 0 0 0 
0 128 0 128 0 0 129 0 129 0 139 136 136 136 136 136 136 136 136 136 136 136 138 0 128 0 0 0 0 0 266 267 0 0 0 0 0 0 0 129 0 139 131 131 131 131 131 131 131 131 
0 128 0 128 0 0 129 0 129 0 128 0 0 0 0 0 0 0 0 0 0 0 129 0 130 131 131 131 131 131 268 269 131 131 131 131 131 131 131 137 0 129 0 0 0 0 0 0 0 0 
0 128 0 128 0 0 129 0 129 0 128 0 139 131 131 131 131 131 131 131 138 0 129 0 0 0 0 0 0 0 0 0 0 0 0 0 0 0 0 0 0 129 0 139 131 131 131 131 138 0 
0 128 0 128 0 0 129 0 129 0 128 0 128 0 0 0 0 0 0 0 129 0 129 0 0 0 0 0 0 0 0 0 0 0 0 0 0 0 0 0 0 129 0 128 0 0 0 0 129 0 
0 128 0 128 0 0 129 0 129 0 128 0 128 0 139 136 136 136 138 0 129 0 129 0 0 0 0 0 0 0 0 0 0 0 0 0 0 0 0 0 0 129 0 128 0 0 0 0 129 0 
0 128 0 128 0 0 129 0 129 0 128 0 128 0 128 0 0 0 129 0 129 0 130 136 136 136 136 136 136 136 136 136 136 136 136 136 136 136 136 136 136 137 0 128 0 0 0 0 129 0 
0 128 0 128 0 0 129 0 129 0 128 0 128 0 128 0 0 0 129 0 129 0 0 0 0 0 0 0 0 0 0 0 0 0 0 0 0 0 0 0 0 0 0 128 0 0 0 0 129 0 
