0 0 0 0 0 0 0 0 0 0 0 0 0 0 0 0 0 0 0 0 0 0 0 0 0 0 0 0 0 0 0 0 0 0 0 0 0 0 0 0 0 0 0 0 0 0 0 0 0 0 
0 0 0 0 0 0 0 0 0 0 0 0 0 0 0 0 0 0 0 0 0 0 0 0 0 0 0 0 0 0 0 0 0 0 0 0 0 0 0 0 0 0 0 0 0 0 0 0 0 0 
0 0 0 0 0 0 0 0 0 0 0 0 0 0 0 0 0 0 0 0 0 0 0 0 0 0 0 0 0 0 0 0 0 0 0 0 0 0 0 0 124 125 125 125 125 127 0 0 0 0 
0 0 0 0 0 151 152 153 0 0 0 0 0 0 0 0 0 0 0 142 143 144 0 0 0 0 0 0 0 0 0 0 0 0 0 0 0 0 0 0 128 0 0 0 0 129 0 0 0 0 
0 0 0 0 0 154 155 156 157 0 0 0 0 0 0 0 0 0 0 145 146 147 0 0 0 0 0 0 140 0 0 0 0 0 0 0 0 0 0 0 128 0 0 0 0 129 0 0 0 0 
0 0 0 0 158 159 160 161 162 0 0 0 0 0 0 0 0 0 0 148 149 150 0 0 0 0 0 0 141 0 0 0 0 0 0 0 0 0 0 0 128 0 0 0 0 129 0 0 0 0 
0 0 0 163 164 165 166 167 168 0 0 0 0 0 0 0 0 0 0 0 0 0 0 0 0 140 0 0 0 0 0 0 0 0 0 0 0 0 0 0 130 131 131 131 131 137 0 0 0 0 
0 0 0 169 170 171 172 173 174 175 0 0 0 0 0 0 0 0 0 0 0 0 0 0 0 141 0 0 0 0 0 0 0 0 0 0 0 0 0 0 0 0 0 0 0 0 0 0 0 0 
0 0 0 176 177 178 179 180 181 0 0 0 0 0 0 0 0 0 0 0 0 0 0 0 0 0 0 0 0 0 0 0 0 0 0 0 0 0 0 0 0 0 0 0 0 0 0 0 0 0 
0 0 0 0 183 184 185 186 187 0 0 0 0 0 0 0 0 0 0 0 0 0 124 126 126 126 125 125 125 125 125 125 125 125 125 125 125 125 125 125 127 0 0 0 0 0 0 0 0 0 
0 0 0 0 0 0 0 0 0 0 0 0 0 0 0 0 0 0 0 0 0 0 128 0 0 0 0 0 0 0 0 0 0 0 0 0 0 0 0 0 129 0 0 0 0 0 0 0 0 0 
0 0 0 0 0 0 0 0 0 0 0 0 151 152 153 0 0 0 0 0 0 0 128 0 0 0 0 0 124 125 125 125 125 125 125 125 127 0 0 0 129 0 0 0 0 0 0 0 0 0 
0 0 0 0 0 0 0 0 0 0 0 0 154 155 156 157 0 0 0 0 0 0 128 0 0 0 0 0 128 0 0 270 271 272 0 0 129 0 0 0 129 0 0 0 0 0 0 0 0 0 
0 0 0 0 0 0 0 0 0 0 0 158 159 160 161 162 0 0 0 0 0 0 128 0 0 0 0 0 128 0 273 274 275 276 277 0 129 0 0 0 129 0 0 0 0 0 0 0 0 0 
0 0 0 0 0 0 0 0 0 0 163 164 165 166 167 168 0 0 0 0 0 0 128 0 0 0 0 0 128 0 278 279 280 281 282 0 129 0 0 0 129 0 0 0 0 0 0 0 0 0 
0 0 0 0 0 0 0 0 0 0 169 170 171 172 173 174 175 0 0 0 0 0 128 0 0 0 0 0 128 0 283 284 285 286 287 0 129 0 0 0 129 0 0 0 0 0 0 0 0 0 
0 0 0 0 0 0 0 0 0 0 176 177 178 179 180 181 182 0 0 0 0 0 128 0 0 0 0 0 130 131 131 131 131 131 131 131 137 0 0 0 129 0 0 0 0 0 0 0 0 0 
0 0 0 0 0 0 0 0 0 0 0 183 184 185 186 187 0 0 0 0 0 0 128 0 0 0 0 0 0 0 0 0 0 0 0 0 0 0 0 0 129 0 0 0 0 0 0 0 0 0 
0 0 0 0 0 0 0 0 0 0 0 0 0 0 0 0 0 0 0 0 0 0 130 131 131 131 131 131 138 0 0 0 0 0 270 271 272 0 0 0 129 0 0 0 0 0 0 0 0 0 
0 0 0 0 124 125 125 125 125 127 0 0 0 0 0 0 0 0 0 0 0 0 0 0 0 0 0 0 128 0 0 0 0 273 274 275 276 277 0 0 129 0 0 0 0 0 0 0 0 0 
0 0 0 0 128 0 0 0 0 129 0 0 0 0 142 143 144 0 0 0 0 0 0 0 0 0 0 0 128 0 0 0 0 278 279 280 281 282 0 0 129 0 0 0 0 0 0 0 0 0 
0 0 0 0 128 0 0 0 0 129 0 0 0 0 145 146 147 0 0 0 0 0 0 0 0 0 0 0 128 0 0 0 0 283 284 285 286 287 0 0 129 0 0 142 143 144 0 0 0 0 
0 0 0 0 128 0 0 0 0 129 0 0 0 0 148 149 150 0 0 0 0 0 0 0 0 0 0 0 128 0 0 0 0 0 0 0 0 0 0 0 129 0 0 145 146 147 0 0 0 0 
0 0 0 0 128 0 0 0 0 129 0 0 0 0 0 0 0 0 0 0 0 0 0 0 0 0 0 0 130 136 136 136 136 134 135 136 136 136 136 136 137 0 0 148 149 150 0 0 0 0 
0 0 0 0 130 131 131 131 131 137 0 0 0 0 0 0 0 0 0 0 0 0 0 0 0 0 0 0 0 0 0 0 0 0 0 0 0 0 0 0 0 0 0 0 0 0 0 0 0 0 
0 0 0 0 0 0 0 0 0 0 0 0 0 0 0 0 0 0 0 151 152 153 0 0 0 0 0 0 0 0 0 0 0 0 0 0 0 0 0 0 0 0 0 0 0 0 0 0 0 0 
0 0 0 0 0 0 0 0 0 0 0 0 0 0 0 0 0 0 0 154 155 156 157 0 0 0 0 0 0 0 0 0 0 0 0 0 0 0 0 0 0 0 0 0 0 0 0 0 0 0 
0 0 0 0 0 0 0 0 0 0 0 0 0 0 0 0 0 0 158 159 160 161 162 0 0 0 0 0 270 271 272 0 0 0 0 0 0 0 0 0 0 0 270 271 272 0 0 0 0 0 
0 0 0 0 0 0 0 0 0 0 0 0 0 0 0 0 0 163 164 165 166 167 168 0 0 0 0 273 274 275 276 277 0 0 0 0 0 0 0 0 0 273 274 275 276 277 0 0 0 0 
0 0 0 270 271 272 0 0 0 0 0 0 142 143 144 0 0 169 170 171 172 173 174 175 0 0 0 278 279 280 281 282 0 0 0 0 142 143 144 0 0 278 279 280 281 282 0 0 0 0 
0 0 273 274 275 276 277 0 0 0 0 0 145 146 147 0 0 176 177 178 179 180 181 182 0 0 0 283 284 285 286 287 0 0 0 0 145 146 147 0 0 283 284 285 287 0 0 0 0 0 
0 0 278 279 280 281 282 0 0 0 0 0 148 149 150 0 0 0 183 184 185 186 187 0 0 0 0 0 0 0 0 0 0 0 0 0 148 149 150 0 0 0 0 0 0 0 0 0 0 0 
0 0 283 284 285 286 287 0 0 0 0 0 0 0 0 142 143 144 0 0 0 0 0 0 0 0 0 0 0 0 0 0 0 0 0 0 0 0 0 0 0 142 143 144 0 0 0 0 0 0 
0 0 0 0 0 0 0 0 0 0 0 142 143 144 0 145 146 147 0 0 0 0 0 0 0 0 0 0 0 0 0 0 0 0 0 0 0 0 0 0 0 145 146 147 0 0 0 0 0 0 
0 0 0 0 0 0 0 0 0 0 0 145 146 147 0 148 149 150 0 0 0 0 0 0 0 0 0 142 143 144 0 0 0 0 0 0 0 0 0 0 0 148 149 150 0 0 0 0 0 0 
0 0 0 0 0 0 0 0 0 0 0 148 149 150 142 143 144 0 0 0 0 0 0 0 0 0 0 145 146 147 0 0 0 0 0 0 0 0 0 0 0 0 0 0 0 0 0 0 0 0 
0 0 0 0 0 0 0 0 0 0 0 142 143 144 145 146 147 0 0 0 0 0 0 0 0 0 0 148 149 150 0 0 0 0 0 0 0 0 0 0 0 0 0 0 0 0 0 0 0 0 
102 0 0 0 0 0 0 0 0 0 0 145 146 147 148 149 150 0 0 0 0 0 0 0 0 0 0 0 0 0 0 0 0 0 0 0 0 0 0 0 0 0 0 0 0 0 0 0 0 0 
97 0 0 0 0 0 0 0 0 0 0 148 149 150 0 0 0 0 0 0 0 0 0 0 0 0 0 0 0 0 0 0 0 0 0 0 0 0 0 0 0 0 0 0 0 0 0 0 105 99 
97 0 0 0 0 71 71 71 71 71 71 71 71 71 71 0 0 0 0 0 0 0 0 0 0 0 0 0 0 0 0 0 0 0 0 0 0 0 270 271 272 0 0 0 0 0 0 0 101 59 
97 0 0 0 0 72 73 73 73 73 73 73 73 73 74 105 99 99 99 99 99 99 99 99 99 99 99 99 99 102 0 0 0 0 0 0 0 273 274 275 276 277 0 0 0 0 0 0 101 59 
97 0 0 0 0 75 76 76 76 76 76 76 76 76 77 101 59 59 59 59 59 59 59 59 59 59 59 59 59 97 0 0 0 0 0 0 0 278 279 280 281 282 0 0 0 0 0 0 101 59 
98 99 99 99 102 75 76 288 289 290 76 76 76 76 77 101 59 59 59 59 59 59 59 59 59 59 59 59 59 97 0 0 0 0 0 0 0 283 284 285 286 287 0 0 0 0 0 0 101 59 
59 59 59 59 97 75 76 291 292 293 76 76 76 76 77 101 59 59 59 59 59 59 59 59 59 59 59 59 59 97 0 0 0 0 0 0 0 0 0 0 0 0 0 0 0 0 0 0 101 59 
59 59 59 59 97 75 76 294 295 296 76 76 76 76 77 101 59 59 59 59 59 59 59 59 59 59 59 59 59 97 0 0 0 0 0 0 0 0 0 0 0 0 0 0 0 0 0 0 101 59 
59 59 59 59 97 75 76 76 76 76 288 289 290 76 77 101 59 59 59 59 59 59 59 59 59 59 59 59 59 97 0 0 0 0 0 0 0 0 0 0 0 0 0 105 99 99 99 99 100 59 
59 59 59 59 97 75 76 76 76 76 291 292 293 76 77 101 59 59 59 59 59 59 59 59 59 59 59 59 59 98 99 99 99 99 99 99 99 99 99 99 99 99 99 100 59 59 59 59 59 59 
59 59 59 59 97 75 76 76 76 76 294 295 296 76 77 101 59 59 59 59 59 59 59 59 59 59 59 59 59 59 59 59 59 59 59 59 59 59 59 59 59 59 59 59 59 59 59 59 59 59 
59 59 59 59 97 75 76 76 76 76 76 76 76 76 77 101 59 59 59 59 59 59 59 59 59 59 59 59 59 59 59 59 59 59 59 59 59 59 59 59 59 59 59 59 59 59 59 59 59 59 
59 59 59 59 97 75 76 76 76 76 76 76 76 76 77 101 59 59 59 59 59 59 59 59 59 59 59 59 59 59 59 59 59 59 59 59 59 59 59 59 59 59 59 59 59 59 59 59 59 59 
